* - - * * 
- - - * - 
- - - - - 
- - - - - 
- - * - - 
