- - - - - 
- - - - - 
- - - - - 
* * * - - 
- - * - * 
